Rabbit	tùzǐ	兔子
Cat	māo	猫
Dog	gǒu	狗
Fish	yú	鱼
Bird	niǎo	鸟
Cow	niú	牛
Horse	mǎ	马
Donkey	lǘ	驴
Fox	húli	狐狸
Frog	qīngwā	青蛙
Gorilla	dàxīngxing	大猩猩
Hyena	liègǒu	鬣狗
Jellyfish	hǎizhé	海蜇
Kangaroo	dàishǔ	袋鼠
Lion	shīzi	狮子
Mouse	shǔ	鼠
Oyster	mǔlì	牡蛎
Sheep	yáng	羊
Pig	zhū	猪
Tiger	lǎohǔ	老虎
Vulture	tūyīng	秃鹰
Wolf	láng	狼
Shark	shāyú	鲨鱼
Squid	wūzéi	乌贼
Zebra	bānmǎ	斑马
