History	lìshǐ	历史
Emperor	huángdì	皇帝
Slave	núlì	奴隶
War	zhànzhēng	战争
Army	jūnduì	军队
Navy	hǎijūn	海军
Air-Force	kōngjūn	空军
Capitalism	zīběnzhǔyì	资本主义
Communism	gòngchǎnzhǔyì	共产主义
Marxism	mǎkèsīzhǔyì	马克思主义
Military	jūnduì	军队
Monarchy	dìzhì	帝制
Fight	dòuzhēng	斗争
Peace	hépíng	和平
Bomb	zhàdàn	炸弹
Missile	dǎodàn	导弹
Politics	zhèngzhì	政治
Upper Class	shàngliú	上流
Middle Class	zhōngchǎnjiējí	中产阶级
Lower Class	xiàcéng jiējí	下层阶级
Government	zhèngfǔ	政府
Election	xuǎnjǔ	选举
