autumn	qiū	秋
meaning	yì	意
concentrated	nóng	浓
depart	lí	离
on my mind	xīnshàng	心上
mood	qíngxù	情绪
parting	líbié	离别
leaf	yè	叶
drop	luò	落
season	jìjié	季节
put	fàng	放
Heart/Soul	xīntóu	心头
remember	jìde	记得
Speechless	wúyán	无言
promise	chéngnuò	承诺
Lovesickness	xiāngsī	相思
bitter	kǔ	苦
only	zhī	只
Pain	shāngtòng	伤痛
blame	yuàn	怨
wind	fēngzhōng	风中
Gather	jù	聚
Scatter	sǎn	散
choice	yóu	由
alone	gūdú	孤独
lonely	jìmò	寂寞
nowhere	wúchù	无处
Sadness	líchóu	离愁
