Oxford	niújīn	牛津
Cambridge	jiànqiáo	剑桥
Masters	dàshī	大师
Undergrad	běnkēshēng	本科生
Phd	bóshìxuéwèi	博士学位
Study	xuéxí	学习
Practice	liànxí	练习
Apprentice (Formal)	xuétú	学徒
Worthy	duìdeqǐ 。	对得起。
Teacher	lǎoshī	老师
Student	xuésheng	学生
Master	shīfu	师傅
exam	kǎoshì	考试
Grades	děngjí	等级
Read	dú	读
Write	xiě	写
Graduate	bìyè	毕业
Strengthen	jiāqiáng	加强
Not good enough	hái bùgòu hào	还不够好
Apprentice (Informal)	túdì	徒弟
